,#######,,,,,
,,,,#     ##,
##### ###  ##
#       #  ##
#@$***. ##$ #
#  #    ## .#
##  ##  # $ #
,##  ####.$.#
,,##        #
,,,######  ##
,,,,,,,,####,
