#########
#. .    #
#.$. .  #
## ###@ #
,#  $  ##
,# $$ ##,
,#  $ #,,
,#  ###,,
,####,,,,
