,###,,,,,,,
,,####,####
,##  ###  #
## $      #
#   @$ #  #
### $###  #
,,#  #..  #
,## ##.# ##
,#      ##,
,#     ##,,
,#######,,,
