 #####         #
          ##   #
          #    #
    ####  # $ ##
    #  ####$ $#
    #     $ $ #
   ## ## $ $ $#
   #  .#  $ $ #
   #  .#      #
##### #########
#.... @  #,,,,,
#....    #,,,,,
##  ######,,,,,
,####,,,,,,,,,,
