#############
.##     #  @#
### $ $$#   #
# ##$    $$ #
#  #  $ #   #
###### ######
#.. ..$ ####.
# ..    ###..
#  ..#####...
#########....
