######,,,,,,,,,,,,,
,,,,####,,##,,,,#,,
,,###  #,,#,,## ###
###    #### #   $ #
#  $ @ ... ..  $  #
# $ $  ## ###   ###
### ###   # #####,,
,#      ###,,,,,,,,
,#   ####,,,,,,,,,,
,#####,,,,,,,,,,,,,
