############,,,
###.  .$.  .###
,## $  $  $ ##,
,,## ..$.. ##,,
,,,##$#$#$##,,,
,,,,#.$ $.#,,,,
,,,,#  @  #,,,,
,,,,### ###,,,,
,,,## $ $ ##,,,
,,,#.  $  .#,,,
,,,### . ###,,,
,,,,,#####,,,,,
