## #####,
## ## . #
# ## $. #
 ## $   #
## $@ ###
# $  ##,,
#.. ## ##
#   #,##,
#####,#,,
