###########,,,
,##    #   ##,,
### $ $#$ $ ###
# #$ $ # $ $# #
# $  ..#..  $ #
#  $...#...$  #
# $ ..   .. $ #
###### @ ######
# $ ..   .. $ #
#  $...#...$  #
# $  ..#..  $ #
# #$ $ # $ $# #
### $ $#$ $ ###
,##    #    ##,
,,###########,,
