01111111111111111111111111111111111111111
01222222222222221222222212222222222222221
01222222222222221222222212222222222222221
01222222222222221222222212222222222222221
01222222232222222222222222222222222222221
01222222222222222222222222222222222222221
01222222222222222222222222222222222222221
01222222222222222222222222222222222222221
01111111122222221122222222222222222222221
01222222222222221122222222222222222222221
01222522242222221122222222222222222222221
01222522242222221122222222222222222222221
01222222222222221122222222222222222222221
 1111111111111111111111111111111111111111

