############,,,,,,
      #    #,,,,,,
      # @  ###,,,,
####  #      #,,,,
#  ####..#.#$#####
# $ $ ##...      #
#     .....#$$   #
###### ##$## #####
,,,,,#  $    #,,,,
,,,,,#### ####,,,,
,,,,,,,#  #,,,,,,,
,,,,,,,#  #####,,,
,,,,,,### $    #,,
,,,,,#  $ $   #,,,
,,,,,# #$# ####,,,
,,,,,#     #,,,,,,
,,,,,#######,,,,,,
