0000000000
0111111110
0122222210
0122222210
0122543210
0111111110
0000000000
